
4  4  4  4  4  4  4  4  4  4  4  4  4  4  4  4  4  4  4  4  4  4  4  4  4  4  4  4
4  4  4  4  4  4  4  4  4  4  4  4  4  4  4  4  4  4  4  4  4  4  4  4  4  4  4  4
4  4  4  4  4  4  4  4  4  4  4  4  4  4  4  4  4  4  4  4  4  4  4  4  4  4  4  4
1  1  1  1  1  1  1  1  1  1  1  1  1  1  1  1  1  1  1  1  1  1  1  1  1  1  1  1
1  0  0  0  0  0  2  0  0  0  0  0  0  1  1  0  0  0  0  0  0  2  0  0  0  0  0  1
1  0  1  1  1  1  0  1  1  1  1  1  0  1  1  0  1  1  1  1  1  0  1  1  1  1  0  1
1  10 1  4  4  1  0  1  4  4  4  1  0  1  1  0  1  4  4  4  1  0  1  4  4  1  10 1
1  0  1  1  1  1  0  1  1  1  1  1  0  1  1  0  1  1  1  1  1  0  1  1  1  1  0  1
1  2  0  0  0  0  2  0  0  2  0  0  2  0  0  2  0  0  2  0  0  2  0  0  0  0  2  1
1  0  1  1  1  1  0  1  1  0  1  1  1  1  1  1  1  1  0  1  1  0  1  1  1  1  0  1
1  0  1  1  1  1  0  1  1  0  1  1  1  1  1  1  1  1  0  1  1  0  1  1  1  1  0  1
1  0  0  0  0  0  2  1  1  0  0  0  0  1  1  0  0  0  0  1  1  2  0  0  0  0  0  1
1  1  1  1  1  1  0  1  1  1  1  1  0  1  1  0  1  1  1  1  1  0  1  1  1  1  1  1
4  4  4  4  4  1  0  1  1  1  1  1  0  1  1  0  1  1  1  1  1  0  1  4  4  4  4  4
4  4  4  4  4  1  0  1  1  0  0  0  2  0  7  2  0  0  0  1  1  0  1  4  4  4  4  4
4  4  4  4  4  1  0  1  1  0  1  1  1  3  3  1  1  1  0  1  1  0  1  4  4  4  4  4
1  1  1  1  1  1  0  1  1  0  1  1  4  6  11 4  1  1  0  1  1  0  1  1  1  1  1  1
0  0  0  0  0  0  2  0  0  2  1  1  4  9  8  4  1  1  2  0  0  2  0  0  0  0  0  0
1  1  1  1  1  1  0  1  1  0  1  1  1  1  1  1  1  1  0  1  1  0  1  1  1  1  1  1
4  4  4  4  4  1  0  1  1  0  1  1  1  1  1  1  1  1  0  1  1  0  1  4  4  4  4  4
4  4  4  4  4  1  0  1  1  2  0  0  0  0  0  0  0  0  2  1  1  0  1  4  4  4  4  4
4  4  4  4  4  1  0  1  1  0  1  1  1  1  1  1  1  1  0  1  1  0  1  4  4  4  4  4
1  1  1  1  1  1  0  1  1  0  1  1  1  1  1  1  1  1  0  1  1  0  1  1  1  1  1  1
1  0  0  0  0  0  2  0  0  2  0  0  0  1  1  0  0  0  2  0  0  2  0  0  0  0  0  1
1  0  1  1  1  1  0  1  1  1  1  1  0  1  1  0  1  1  1  1  1  0  1  1  1  1  0  1
1  0  1  1  1  1  0  1  1  1  1  1  0  1  1  0  1  1  1  1  1  0  1  1  1  1  0  1
1  10 0  0  1  1  2  0  0  2  0  0  2  0  0  2  0  0  2  0  0  2  1  1  0  0  10 1
1  1  1  0  1  1  0  1  1  0  1  1  1  1  1  1  1  1  0  1  1  0  1  1  0  1  1  1
1  1  1  0  1  1  0  1  1  0  1  1  1  1  1  1  1  1  0  1  1  0  1  1  0  1  1  1
1  0  0  2  0  0  0  1  1  0  5  0  0  1  1  0  0  0  0  1  1  0  0  0  2  0  0  1
1  0  1  1  1  1  1  1  1  1  1  1  0  1  1  0  1  1  1  1  1  1  1  1  1  1  0  1
1  0  1  1  1  1  1  1  1  1  1  1  0  1  1  0  1  1  1  1  1  1  1  1  1  1  0  1
1  0  0  0  0  0  0  0  0  0  0  0  2  0  0  2  0  0  0  0  0  0  0  0  0  0  0  1
1  1  1  1  1  1  1  1  1  1  1  1  1  1  1  1  1  1  1  1  1  1  1  1  1  1  1  1
4  4  4  4  4  4  4  4  4  4  4  4  4  4  4  4  4  4  4  4  4  4  4  4  4  4  4  4
4  4  4  4  4  4  4  4  4  4  4  4  4  4  4  4  4  4  4  4  4  4  4  4  4  4  4  4